O O O O O O O O O O O O O O O O O O O O O O O O O O O O O O O
O G G G G G G G G G G G G G G G G G G G G G G G G G G G G G O
O G P P P P P P P P P P P P R R R R R R R G G G G G G G G G O
O G P G G G G G M G G G G G R R R R R R R G G G G G G G G G O
O G P G P P P P P P P P P P R R R R R R R G G G G G G G G G O
O G P G P G G G G G G G P B G G G G G G G G G G G G G G G G O
O G P P P G G G G G P P P G G G G G G G G G G G B G G G G G O
O G G G G G G G G G P B G G G G G G G G G G G G G G G G G G O
O G G G G G G M G G P P P P P G G G G G G G G G G G G G M G O
O G G G G G G G G G G G G G P G M G G G G G G G G G G G G G O
O G G G G G G G P P P P P P M G G G G G G G G G G G G G G G O
O G G G G G G G P B G G G G G G G M G G G G G G G G G G G G O
O G G G G G G G P P M R R R R R R G G G R R R M R R R G G G O
O G G G G G G G P G R R R R M R R G G B R R R R R R R G B G O
O G B P P G P P P G R R R R R R R G G G R R R R R R R G G G O
O G P G P G P M G G R R R R R R R G G G R R R R R R R G G G O
O G P G P P P G G G R R R R R R R G G G R R R R R R R G G G O
O B P G G G G G G G G G G G G G G G G G R R R R R R R G G G O
O G P P P P P P P P P P P P P P P G G G R M R R R R R P P G O
O G G G G G G G G G G G P G G G P G G G G G G G G B G G P G O
O G G G G G P P P P P P P G G G P P P G G G G G G G G G P G O
O G G G G G P M G G G G G G G G G G P G G G G G G G G G P G O
O G B G P P P G G G G G R R R G G G P P P P P G G G G G P G O
O G G G P G G G G G G G R R R G G G G G G G P G G G G G P G O
O G P P P G G G G G G G R R R G P P P P P P P G G G P P P G O
O G P G G G G G G G G G R R R G P G G G G G G G G G P G G G O
O G P P P P P P P P P P R R R G P P P G G G G G G G P G G G O
O G G G G G G G G G P G R R R G G G M G G G G G G G P G G G O
O G P P P P P P P P P G R R R G G G P P P P P P P P P G G G O
O G P G G G G G G G G G G G G G G G G G G G G B G G G G G G O
O O O O O O O O O O O O O O O O O O O O O O O O O O O O O O O
