O O O O O O O O O O O O O O O O O O O O O O O O O O O O O O O O O O O O O O O O O O O O O
O G G G G G P G G G G G G G G G G G G G G G P G G G P G G G G G G G G G G G G G G G G G O
O P P P P G P P P P P P P P P P P P P G P P P P P P P P P P P P P P R R R R R G G G G G O
O G P G P G P G G G G G G M P G G G P G P G P G G G P G G G G G P G R R R R R B G G G G O
O G M G P P P G R R R R R R R G G G P B P G P P P G P P P G G G P G R R R R R G G G G G O
O G P G G G G G R B R R R R R G G G P G G G G G G G G G G G G G G G G G G G B G G G G G O
O G P P P P P G R B R R R R R G G G P P P G G M R R R R R G G G G G G G G G G G G G G G O
O G G G G G P G R R R R R M R G G G G G P G G G R R R R R G G G G G G G G G G G G G G G O
O G P P P P P G R R R R R R R G G G P P P G G G R R R R R G G G G G G G G G G G G G G G O
O G G G G G G G G G G G G G G G G G P G G G G G G G P G G G G G G G G G G G G G G G G G O
O G P P P P P P P G G G G G G G P P P G P P P G P P P P P P P G G G G G G G G G G M G G O
O G P G G G P G P G G G G G G G P G G G P G P G P G G G G G P G G G G G G G G G G G G G O
O G P G P P P M P P P P P G G G P P P P P G P P P G P P P P P G G G G G R R R R R G G G O
O G P G G G G G M G G G P G G G G G G G G G G G G G P G G G G B G G G G R R R R R G G G O
O G P P P P P G P P P G P G R R R R R R R R R P P P P G P P P P P P P G R R M R R G G G O
O G G G G G P G G G P G G G R R R R R R R R R G P G G G P G G G P G P G R R R B R G G G O
O G P P P P P P P P P G P G R R R R R R R R R G P G P P P G P P P G P G R R R R R G G G O
O G P G G G G G G G G G P G G G G G G G G G G G P G P G G G G G G G P G R R R R R G G G O
O G P P P P P G G G P P P G G G G G G M G G G G P P P G P M P P P P P M R R R R R G G G O
O G G G G G P G G G P M G G G G G G G G G G G G G G G G G G G G P G P G R R R R R G G G O
O G P P P P M G P P M G G G G G G M G G G G G G G G P P P P P P P G P G M R R R R G G G O
O G B G G G G G P G G G G G G G G G G G G G G G G G G G G G G G G B P G P G G B G G G G O
O G P G P P P P P G G G G G G G G G G G G G G G G G R R R R R R R P P P P B P P P P P P O
O G P G P G G G G G G G G G B G G G B G G G G G G G R R R R R R R G P G G G G G P G G G O
O G P G P G G G G G G G G G G G G G G G G G G G P G R R R R M R R G P P P G G G P G B G O
O G P G P G G G G G G G G G G G G G G M G G G G P G G G G G G G P G G G P G G G P G P G O
O G P P P G G G G G R R R R R R R M G G P P P P P G P G P P P G P G P P P G G G P P P G O
O G P G G G G G G G R R R M R R R G G G P G G G G G P G P G P G P G P G G G G G G G P G O
O B P G G G G G G G R R R R R R R G G G P P P P P P P P P G P P P G P G R R R R R G P P O
O G G G G G G G G G R R R R R R R G G G P G G G G G P G P G P G G G P G R R R R R G P G O
O P P P P G G G G G R R R R R R R M G G P G G G P P P P P P P P P P P G R R R R R G P G O
O G G G P G G G G G G G G G P G G G G G P G G G P G G G G G M G G G G G R R R R R G P G O
O G P P P G G G G G G G P P P P P G G G P P P G P P P P P P P P P P P G R R B R R G P G O
O G P G G G G G G G G G P G G G P G G G G G P G P G G G G G P G P G P G R R R R R G G G O
O G P G G G P P P P P P P G G G P P P P P G P G P P P P P G P G P G P G R M R R R G P P O
O G P G G G P G G G G G G G G G B G G G P G P G G G G G G G P G P G P G R R R R R G P G O
O G P P P G P P P G G G G G G G G G G G P G P G P P P P P P P G P G P G R R R R R G P G O
O G G G P G G G P G G G G G G G G G G G P G P G G G G G G G P G G G P G P G G G P G P G O
O G P P P G G G P G G G G G G G G G G G P G P G R R R R R R R R R P P P P P P G P G P G O
O G P G G G G G P G G G G G G G G G G G P G P G R R R R R R R R R G P G G G P G P G P G O
O G P M G G G G P P P G G G R R R R R R R G P G R R R R R R R R R G P G P G P P P P P G O
O G P G G G G G G G P G G G M R R R R R R G G G G G G G G G G G G G P G P G P G G G P G O
O G P P P P P P P P P G G G R R R R R R R G G G G G G G G G G G G G P P P P P P P P P G O
O G G G G G G G G G G G G G G G G G G G G G G G G G G G G G G G G G G G G G G M G G G G O
O O O O O O O O O O O O O O O O O O O O O O O O O O O O O O O O O O O O O O O O O O O O O
